{

  "SizeOfGrid": {
    "x": 15,
    "y": 10
  },
  "Grid0Test": [
    [ 0, 0, 0, 1, 0, 0, 0 ],
    [ 0, 0, 0, 1, 0, 0, 0 ],
    [ 0, 0, 0, 1, 0, 0, 0 ],
    [ 1, 1, 1, 3, 1, 1, 5 ],
    [ 0, 0, 0, 1, 0, 0, 0 ],
    [ 0, 0, 0, 1, 0, 0, 0 ],
    [ 0, 0, 0, 1, 0, 0, 0 ]
  ],

  "Level01": [
    [ 1, 0, 0, 0,16, 0, 0, 0, 0, 0, 1, 1, 1, 1, 5 ],
    [ 1, 0, 0, 8, 8, 0, 0, 8, 0, 0, 1, 0,16, 0, 0 ],
    [ 1,16, 0, 8, 8,16, 0, 8, 0, 0, 1, 0, 0, 0, 0 ],
    [ 1, 0, 0, 8, 8, 0, 0, 8,16, 0, 1, 0, 8, 8, 8 ],
    [ 1, 0, 0, 8, 8, 0, 0, 8, 0, 0, 1, 0, 8, 8, 8 ],
    [ 1, 1, 0, 8, 8, 0, 0, 8, 0, 0, 1, 0, 8, 8, 8 ],
    [ 0, 1, 0, 0, 0, 0,16, 0,16, 0, 1, 0, 0, 0, 0 ],
    [ 0, 1, 1, 1, 1, 0, 0, 0, 0, 0, 1, 0, 0, 0, 0 ],
    [ 8, 0, 0, 0, 1, 0, 0, 0, 0, 0, 1, 0, 0, 0, 8 ],
    [ 8, 8, 0, 0, 1, 1, 1, 3, 1,33, 1, 0, 0, 8, 8 ]
  ],

  "Level02": [
    [ 1, 1, 1, 1, 1, 1, 0, 0,16, 0,16, 0, 0, 1, 5 ],
    [ 0, 8, 8, 0, 0, 1, 0, 0, 0, 0, 0, 0, 0, 1, 0 ],
    [ 0, 8, 8, 0, 0, 1, 0, 8, 8, 8, 8, 8, 0, 1, 0 ],
    [16, 8, 8,16, 0, 1, 0, 8, 8, 8, 8, 8, 0, 1, 0 ],
    [ 8, 8, 8, 8, 0, 1, 0, 0, 0, 0, 0, 0, 0, 1, 0 ],
    [ 8, 8, 8, 8, 0, 1, 0,16, 0, 0, 1, 1, 1, 1, 0 ],
    [ 0, 8, 8, 0, 0, 1, 0, 8, 8, 0, 1, 0, 0, 0, 0 ],
    [ 0,16,16, 0, 0, 1, 8, 8, 8, 8, 1, 0, 8, 8, 0 ],
    [ 8, 0, 0, 0, 0, 1, 0, 8, 8, 0, 1, 0, 8, 8, 0 ],
    [ 8, 8, 0, 0, 0,33, 1, 3, 1, 1, 1, 0, 0, 0, 0 ]
  ],

  "Level03": [
    [ 1, 1, 1, 1, 1,16, 0,16, 0,16, 1, 1, 1, 1, 5 ],
    [ 8, 8, 0, 0, 1, 0, 8, 0, 0, 0, 1, 0,16,16, 0 ],
    [ 8, 0, 0, 0, 1, 0, 8, 0, 8, 0, 1, 0, 8, 8, 0 ],
    [ 0,16,16, 0, 1, 0, 8, 0, 8, 0, 1, 8, 8, 8, 8 ],
    [ 8, 8, 8, 8, 1, 0, 8, 0, 8, 0, 1, 8, 8, 8, 8 ],
    [ 8, 8, 8, 8, 1, 1, 1,33, 1, 1, 1, 0, 8, 8, 0 ],
    [ 0, 8, 8, 0, 0, 8, 0, 1, 0, 8, 0, 0, 0, 0, 0 ],
    [ 0, 0, 0, 0, 0, 8, 0, 1, 0, 8, 0, 0, 0, 0, 0 ],
    [ 8, 0, 0, 0, 0, 8, 0, 1, 0, 8, 0, 0, 0, 0, 8 ],
    [ 8, 8, 0, 0, 0, 8, 0, 3, 0, 8, 0, 0, 0, 8, 8 ]
  ]
}