{

  "SizeOfGrid": {
    "x": 15,
    "y": 10
  },
  "Grid0Test": [
    [ 0, 0, 0, 1, 0, 0, 0 ],
    [ 0, 0, 0, 1, 0, 0, 0 ],
    [ 0, 0, 0, 1, 0, 0, 0 ],
    [ 1, 1, 1, 3, 1, 1, 5 ],
    [ 0, 0, 0, 1, 0, 0, 0 ],
    [ 0, 0, 0, 1, 0, 0, 0 ],
    [ 0, 0, 0, 1, 0, 0, 0 ]
  ],

  "Level01": [
    [ 1, 0, 0, 0,16, 0, 0, 0, 0, 0, 1, 1, 1, 1, 1 ],
    [ 1, 0, 0, 8, 8, 0, 0, 8, 0, 0, 1, 0,16, 0, 0 ],
    [ 1,16, 0, 8, 8,16, 0, 8, 0, 0, 1, 0, 0, 0, 0 ],
    [ 1, 0, 0, 8, 8, 0, 0, 8,16, 0, 1, 0, 8, 8, 8 ],
    [ 1, 0, 0, 8, 8, 0, 0, 8, 0, 0, 1, 0, 8, 8, 8 ],
    [ 1, 1, 0, 8, 8, 0, 0, 8, 0, 0, 1, 0, 8, 8, 8 ],
    [ 0, 1, 0, 0, 0, 0,16, 0,16, 0, 1, 0, 0, 0, 0 ],
    [ 0, 1, 1, 1, 1, 0, 0, 0, 0, 0, 1, 0, 0, 0, 0 ],
    [ 8, 0, 0, 0, 1, 0, 0, 0, 0, 0, 1, 0, 0, 0, 8 ],
    [ 8, 8, 0, 0, 1, 1, 1, 3, 1, 1, 1, 0, 0, 8, 8 ]
  ]
}